
###############
#   #     #   #
# ### # # # ###
#  !# # #     #
# ### ### ### #
# #     # #   #
# ### # #######
#     #   #   #
# # # # ##### #
# # # #       #
# ####### #####
#   #     # # ?
# ##### # # # #
#   #   #     #
###############
